7
7
  ***  
 ***** 
***.***
*******
*******
 ***** 
  ***  
