9
9
    *    
   ***   
  *****  
 ******* 
****.****
 ******* 
  *****  
   ***   
    *    